###オセアニア###
AST = "common/countries/commonwealth.txt" #オーストラリア連邦
NZL = "common/countries/commonwealth.txt" #ニュージーランド

###アジア###
JAP = "countries/asian.txt" #大日本帝国
KOR = "countries/asian.txt" #韓国

FRI = "countries/asian.txt" #フランス領インドシナ残党
INC = "countries/asian.txt" #インドシナ独立同盟会
SIA = "countries/asian.txt" #シャム王国
RAJ = "countries/asian.txt" #インド連邦
MAL = "countries/asian.txt" #マラヤ連合

CHI = "countries/asian.txt" ###未使用
PRC = "countries/asian.txt" ###未使用
###中国
#New
#Clique
MAN = "countries/asian.txt" #奉天
SHD = "countries/asian.txt" #山東
SHX = "countries/asian.txt" #山西
GMJ = "countries/asian.txt" #西北軍(国民軍)
ZHI = "countries/asian.txt" #湖北(直隷派)
FPA = "countries/asian.txt" #八省連合
GUW = "countries/asian.txt" #両広
YUN = "countries/asian.txt" #雲南
SIC = "countries/asian.txt" #四川
NIN = "countries/asian.txt" #寧海
TIB = "countries/asian.txt" #西蔵
SIK = "countries/asian.txt" #新疆
#Nationalist
NRA = "countries/asian.txt" #国民革命軍

MPR = "countries/asian.txt" #モンゴル人民共和国
MON = "countries/asian.txt"

AFG = "countries/asian.txt"
